11111111111111111111111111111
10010000000C0000000000C000001
10000111110000000000000000001
1P0011E000000000000000C000001
11111111111111111111111111111
