1111111111111111111111111111111111
110000000000000C00000C0000P1000001
1010010100100000101001000010010101
1010010010101010001001000000010101
110000000C00C0000000000000000001C1
1000000000000000000000000000000011
1000000000000000000000000000000001
1000000000000000000000000000000001
1000000000000000000000000000000001
1111111111111111111111111111111111